context_pre	pre_lemma
...	polemica
subì	subire
macinava	macinare
,	parola
frase,"	frase
muove	muovere
con	con
lanciare	lanciare
macinato	macinare
metri,	metro
fare	fare
Italia:	Italia
raccontato	raccontare
sfornano	sfornare
fanno	fare
ammucchiando	ammucchiare
bevuto""	bere
colpendo	colpire
sommandosi	sommare
assorbono	assorbire
mettere	mettere
chiamano"	chiamare
produceva"	produrre
firmando	firmare
spaziotempo	spaziotempo
costruito	costruire
ordinando	ordinare
sinistra	sinistra
risolvessero	risolvere
frullare	frullare
organizzare	organizzare
restituiti,restituire
permessi,	permesso
«	Lydia
macinano	macinare
Marte,	Marte
sopportare	sopportare
disegnavano	disegnare
fare	fare
scalpello	scalpello
ribatteva	ribattere
risposto	rispondere
rispondendo	rispondere
"""	rispondere
confronterebbe	confrontare
davvero	davvero
dolorose	doloroso
ribatte	ribattere
israeliane	israeliano
luterani	luterano
restituire	restituire
rintuzza	rintuzzare
ribattere	ribattere
rispondere	rispondere
rispondere	rispondere
rispondendo	rispondere
ribattere	ribattere
Masina	Masina
stesso,	stesso
rispondergli	rispondere
controbattendo	controbattere
rispondendo	rispondere
ribattere	ribattere
restituiva	restituire
reagire	reagire
rispondo	rispondere
all'attacco	attacco
restituito	restituire
reagito	reagire
ovvero	ovvero
fare"	fare
volanti,	volante
accatastate	accatastare
mangiare	mangiare
metteva	mettere
trafiggere	trafiggere
fanno	fare
su	su
successivi,	successivo
389:	389
produrre	produrre
scatenarsi	scatenare
vedere	vedere
trattamento,	trattamento
snocciolare	snocciolare
vita,	vita
snervante,	snervante
riunioni,	riunione
far"	fare
iniziano	iniziare
fare	fare
e	e
su	su
far	fare
fare	fare
a	a
instillare	instillare
accumulare	accumulare
ieri	ieri
testimoniare	testimoniare
accumulare	accumulare
laggiù,	laggiù
fatto	fare
accumulato	accumulare
faccio	fare
citare	citare
in	in
risparmiando	risparmiare
ambrosiana,	ambrosiano
indire	indire
distinguo	distinguere
incassate	incassare
vedere	vedere
potenzialità,"	potenzialità
riempie	riempire
strappare	strappare
togliere	togliere
compilava	compilare
soffitto:	soffitto
scatta	scattare
scatta	scattare
brandello,	brandello
inanella	inanellare
battezzava	battezzare
avuto	avere
influenzato	influenzare
via	via
dimostrare	dimostrare
inanellava	inanellare
atti	atto
km	km
edilizio,	edilizio
accavallando"	accavallare
tempo	tempo
affastellando	affastellare
addosso	addosso
di	di
strologando	strologare
continuamente	continuamente
macinando	macinare
strati,	strato
affastellare"	affastellare
vuoti,	vuoto
inchiodano	inchiodare
scriveva	scrivere
scrivere	scrivere
invia	inviare
scrive	scrivere
di	di
continuazione	continuare
sforna	sfornare
leggere	leggere
leggere	leggere
succhiando	succhiare
mille,	mille
recuperare"	recuperare
diede	dare
di	di
costruire	costruire
costruita	costruire
passo,	passo
edificare	edificare
mondo	mondo
lavoravano,	lavorare
-	essere
divorare	divorare
ingoiato	ingoiare
svizzera"	svizzera
fate	fare
risparmiare	risparmiare
sempre	sempre
compilare	compilare
totale,	totale
accumulo:	accumulare
con	con
accumula	accumulare
intrecciare	intrecciare
snocciola	snocciolare
sventagliò	sventagliare
con	con
incessantemente	incessantemente
sollevando	sollevare
avuto	avere
creare	creare
conseguenze:	conseguenza
ribattendo	ribattere
d'arte,	arte
voga	voga
scriveva	scrivere
dio	dio
passare	passare
teatro	teatro
accumulato	accumulare
–	cucina
su	su
divorando	divorare
disposizione	disposizione
batterci	battere
giocano	giocare
respinge	respingere
recuperato	recuperare
recupera	recuperare
avvicinato	avvicinare
difendere,	difendere
romantico	romantico
Confermo	confermare
detti	dare
piallare	piallare
un	un
commettono	commettere
sedere,	sedere
senza	senza
necessari	necessario
giorno	giorno
ricostruiti	ricostruire
elaborando	elaborare
edificio,	edificio
cercato	cercare
aggiungendo	aggiungere
-	cumulativamente
edificato	edificare
costruito	costruire
costruita	costruire
me	me
neppure	neppure
dove	dove
risalito	risalire
risalire	risalire
famiglia,	famiglia
sfornare	sfornare
casse	cassa
,	accusa
porta	portare
lavoro	lavoro
ormai	ormai
Belbo	Belbo
a	a
fa	fare
esperimenti,	esperimento
segnare	segnare
accumula	accumulare
guadagnando	guadagnare
rivendica	rivendicare
lottare	lottare
respinto	respingere
dimostrazione	dimostrare
ribattuto	ribattere
risponde	rispondere
Lauda,	Lauda
ribattere	ribattere
replica	replicare
così	così
lottando	lottare
contrastare	contrastare
così,	così
macinando	macinare
macinano	macinare
risucchiati,	risucchiati
presentando	presentare
sommo	sommare
queste	questo
tutt'Italia,	Italia
accumulano	accumulare
accumula	accumulare
collezionando	collezionare
più:	più
sovrapponendo	sovrapporre
svolgendo	svolgere
fare	fare
e	e
facevo	fare
fare	fare
susseguono	susseguire
inghiottire	inghiottire
assassino,	assassino
tregua	tregua
disperati,	disperato
svaniscono	svanire
goccia,	goccia
collezionare	collezionare
recapitare	recapitare
inanellando	inanellare
prendeva	prendere
palcoscenico	palcoscenico
sono	essere
su	su
perdere	perdere
appaiono	apparire
con	con
collezionando	collezionare
di	di
anche,	anche
sfornare	sfornare
e	e
chiedere	chiedere
fare	fare
su	su
individui	individuo
chiedere	chiedere
colore,	colore
subite	subire
trascorsero	trascorrere
intrecciare	intrecciare
raccontare	raccontare
giorno,	giorno
da	da
sovrapposti"	sovrapporre
incollati	incollare
formando,	formare
teglia	teglia
che,	che
cipolla,	cipolla
sistemate	sistemare
macinano	macinare
vita,	vita
aggiungendo	aggiungere
stelle,	stella
grigliato,	grigliato
mandare	mandare
spedivi	spedire
espropria	espropriare
guadagnando	guadagnare
mattone,	mattone
cisto	cisto
fango,	fango
ricostruiti	ricostruire
sfornava	sfornare
accumulava	accumulare
alimentato	alimentare
strade,	strada
Giovanni,	Giovanni
pubblicato	pubblicare
elevano	elevare
sforna	sfornare
significato	significato
immolare	immolare
consultare	consultare
raccatta	raccattare
sarà	essere
conquistare	conquistare
